Abad	Damien	Les Républicains	Les Républicains
Abeille	Laurence	Écologiste	Europe Ecologie Les Verts
Aboubacar	Ibrahim	Socialiste, républicain et citoyen	Parti socialiste
Aboud	Élie	Les Républicains	Les Républicains
Accoyer	Bernard	Les Républicains	Les Républicains
Adam	Patricia	Socialiste, républicain et citoyen	Parti socialiste
Alaux	Sylviane	Socialiste, républicain et citoyen	Parti socialiste
Alauzet	Éric	Écologiste	Europe Ecologie Les Verts
Albarello	Yves	Les Républicains	Les Républicains
Allain	Brigitte	Écologiste	Europe Ecologie Les Verts
Allossery	Jean-Pierre	Socialiste, républicain et citoyen	Parti socialiste
Ameline	Nicole	Les Républicains	Les Républicains
Amirshahi	Pouria	Socialiste, républicain et citoyen	Parti socialiste
Andrieux	Sylvie	Non inscrit	Non rattachée
André	François	Socialiste, républicain et citoyen	Parti socialiste
Apparu	Benoist	Les Républicains	Les Républicains
Appéré	Nathalie	Socialiste, républicain et citoyen	Parti socialiste
Arif	Kader	Socialiste, républicain et citoyen	Parti socialiste
Arribagé	Laurence	Les Républicains	Les Républicains
Asensi	François	Gauche démocrate et républicaine	Forces de Gauche
Assaf	Christian	Socialiste, républicain et citoyen	Parti socialiste
Attard	Isabelle	Écologiste	Europe Ecologie Les Verts
Aubert	Julien	Les Républicains	Les Républicains
Audibert Troin	Olivier	Les Républicains	Les Républicains
Auroi	Danielle	Écologiste	Europe Ecologie Les Verts
Aylagas	Pierre	Socialiste, républicain et citoyen	Parti socialiste
Ayrault	Jean-Marc	Socialiste, républicain et citoyen	Parti socialiste
Azerot	Bruno Nestor	Gauche démocrate et républicaine	Mouvement initiative populaire
Bachelay	Alexis	Socialiste, républicain et citoyen	Parti socialiste
Bachelay	Guillaume	Socialiste, républicain et citoyen	Parti socialiste
Bacquet	Jean-Paul	Socialiste, républicain et citoyen	Parti socialiste
Baert	Dominique	Socialiste, républicain et citoyen	Parti socialiste
Bailliart	Guy	Socialiste, républicain et citoyen	Parti socialiste
Balkany	Patrick	Les Républicains	Les Républicains
Bapt	Gérard	Socialiste, républicain et citoyen	Parti socialiste
Barbier	Frédéric	Socialiste, républicain et citoyen	Parti socialiste
Barbier	Jean-Pierre	Les Républicains	Les Républicains
Bardy	Serge	Socialiste, républicain et citoyen	Parti socialiste
Bareigts	Ericka	Socialiste, républicain et citoyen	Parti socialiste
Bartolone	Claude	Socialiste, républicain et citoyen	Parti socialiste
Bataille	Christian	Socialiste, républicain et citoyen	Parti socialiste
Batho	Delphine	Socialiste, républicain et citoyen	Parti socialiste
Battistel	Marie-Noëlle	Socialiste, républicain et citoyen	Parti socialiste
Baumel	Laurent	Socialiste, républicain et citoyen	Parti socialiste
Baumel	Philippe	Socialiste, républicain et citoyen	Parti socialiste
Baupin	Denis	Écologiste	Europe Ecologie Les Verts
Bays	Nicolas	Socialiste, républicain et citoyen	Parti socialiste
Beaubatie	Catherine	Socialiste, républicain et citoyen	Parti socialiste
Bechtel	Marie-Françoise	Socialiste, républicain et citoyen	Parti radical de gauche
Beffara	Jean-Marie	Socialiste, républicain et citoyen	Parti socialiste
Bello	Huguette	Gauche démocrate et républicaine	Pour la Réunion, de toutes nos forces
Belot	Luc	Socialiste, républicain et citoyen	Parti socialiste
Benoit	Thierry	Union des démocrates et indépendants	Union des Radicaux, centristes, indépendants et démocrates
Berger	Karine	Socialiste, républicain et citoyen	Parti socialiste
Berrios	Sylvain	Les Républicains	Les Républicains
Berthelot	Chantal	Socialiste, républicain et citoyen	Parti socialiste Guyanais
Bertrand	Xavier	Les Républicains	Les Républicains
Besse	Véronique	Non inscrit	Debout la France (Debout la République)
Bies	Philippe	Socialiste, républicain et citoyen	Parti socialiste
Binet	Erwann	Socialiste, républicain et citoyen	Parti socialiste
Biémouret	Gisèle	Socialiste, républicain et citoyen	Parti socialiste
Blanc	Étienne	Les Républicains	Les Républicains
Blazy	Jean-Pierre	Socialiste, républicain et citoyen	Parti socialiste
Blein	Yves	Socialiste, républicain et citoyen	Parti socialiste
Bleunven	Jean-Luc	Socialiste, républicain et citoyen	Parti socialiste
Bloche	Patrick	Socialiste, républicain et citoyen	Parti socialiste
Bocquet	Alain	Gauche démocrate et républicaine	Parti communiste français
Boisserie	Daniel	Socialiste, républicain et citoyen	Parti socialiste
Bompard	Jacques	Non inscrit	Debout la France (Debout la République)
Bonneton	Michèle	Écologiste	Europe Ecologie Les Verts
Bonnot	Marcel	Les Républicains	Les Républicains
Borgel	Christophe	Socialiste, républicain et citoyen	Parti socialiste
Bouchet	Jean-Claude	Les Républicains	Les Républicains
Boudié	Florent	Socialiste, républicain et citoyen	Parti socialiste
Bouillon	Christophe	Socialiste, républicain et citoyen	Parti socialiste
Bouillé	Marie-Odile	Socialiste, républicain et citoyen	Parti socialiste
Bourdouleix	Gilles	Non inscrit	Association PSLE - Nouveau Centre
Bourguignon	Brigitte	Socialiste, républicain et citoyen	Parti socialiste
Boutih	Malek	Socialiste, républicain et citoyen	Parti socialiste
Bouziane	Kheira	Socialiste, républicain et citoyen	Parti socialiste
Boyer	Valérie	Les Républicains	Les Républicains
Breton	Xavier	Les Républicains	Les Républicains
Briand	Philippe	Les Républicains	Les Républicains
Bricout	Jean-Louis	Socialiste, républicain et citoyen	Parti socialiste
Bridey	Jean-Jacques	Socialiste, républicain et citoyen	Parti socialiste
Brochand	Bernard	Les Républicains	Les Républicains
Bruneau	Isabelle	Socialiste, républicain et citoyen	Parti socialiste
Bréhier	Emeric	Socialiste, républicain et citoyen	Parti socialiste
Buffet	Marie-George	Gauche démocrate et républicaine	Parti communiste français
Bui	Gwenegan	Socialiste, républicain et citoyen	Parti socialiste
Buis	Sabine	Socialiste, républicain et citoyen	Parti socialiste
Buisine	Jean-Claude	Socialiste, républicain et citoyen	Parti socialiste
Bulteau	Sylviane	Socialiste, républicain et citoyen	Parti socialiste
Burroni	Vincent	Socialiste, républicain et citoyen	Parti socialiste
Bussereau	Dominique	Les Républicains	Les Républicains
Bénisti	Jacques Alain	Les Républicains	Les Républicains
Calmette	Alain	Socialiste, républicain et citoyen	Parti socialiste
Cambadélis	Jean-Christophe	Socialiste, républicain et citoyen	Parti socialiste
Candelier	Jean-Jacques	Gauche démocrate et républicaine	Parti communiste français
Capdevielle	Colette	Socialiste, républicain et citoyen	Parti socialiste
Capet	Yann	Socialiste, républicain et citoyen	Parti socialiste
Caresche	Christophe	Socialiste, républicain et citoyen	Parti socialiste
Carlotti	Marie-Arlette	Socialiste, républicain et citoyen	Parti socialiste
Carpentier	Jean-Noël	Radical, républicain, démocrate et progressiste	Parti radical de gauche
Carrey-Conte	Fanélie	Socialiste, républicain et citoyen	Parti socialiste
Carrez	Gilles	Les Républicains	Les Républicains
Carrillon-Couvreur	Martine	Socialiste, républicain et citoyen	Parti socialiste
Carré	Olivier	Les Républicains	Les Républicains
Carvalho	Patrice	Gauche démocrate et républicaine	Parti communiste français
Castaner	Christophe	Socialiste, républicain et citoyen	Parti socialiste
Cathala	Laurent	Socialiste, républicain et citoyen	Parti socialiste
Caullet	Jean-Yves	Socialiste, républicain et citoyen	Parti socialiste
Cavard	Christophe	Écologiste	Parti socialiste
Censi	Yves	Les Républicains	Les Républicains
Chabanne	Nathalie	Socialiste, républicain et citoyen	Parti socialiste
Chalus	Ary	Radical, républicain, démocrate et progressiste	Guadeloupe unie socialisme et réalité
Chambefort	Guy	Socialiste, républicain et citoyen	Parti socialiste
Chanteguet	Jean-Paul	Socialiste, républicain et citoyen	Parti socialiste
Chapdelaine	Marie-Anne	Socialiste, républicain et citoyen	Parti socialiste
Charasse	Gérard	Radical, républicain, démocrate et progressiste	Parti radical de gauche
Charroux	Gaby	Gauche démocrate et républicaine	Parti communiste français
Chartier	Jérôme	Les Républicains	Les Républicains
Chassaigne	André	Gauche démocrate et républicaine	Parti communiste français
Chatel	Luc	Les Républicains	Les Républicains
Chauveau	Guy-Michel	Socialiste, républicain et citoyen	Parti socialiste
Chauvel	Dominique	Socialiste, républicain et citoyen	Parti socialiste
Cherki	Pascal	Socialiste, républicain et citoyen	Parti socialiste
Cherpion	Gérard	Les Républicains	Les Républicains
Chevrollier	Guillaume	Les Républicains	Les Républicains
Christ	Jean-Louis	Les Républicains	Les Républicains
Chrétien	Alain	Les Républicains	Les Républicains
Cinieri	Dino	Les Républicains	Les Républicains
Ciot	Jean-David	Socialiste, républicain et citoyen	Parti socialiste
Ciotti	Éric	Les Républicains	Les Républicains
Claeys	Alain	Socialiste, républicain et citoyen	Parti socialiste
Claireaux	Stéphane	Radical, républicain, démocrate et progressiste	Cap sur l'avenir
Clergeau	Marie-Françoise	Socialiste, républicain et citoyen	Parti socialiste
Clément	Jean-Michel	Socialiste, républicain et citoyen	Parti socialiste
Cochet	Philippe	Les Républicains	Les Républicains
Colas	Romain	Socialiste, républicain et citoyen	Parti socialiste
Collard	Gilbert	Non inscrit	Front national
Comet	David	Socialiste, républicain et citoyen	Parti socialiste
Cope	Jean-François	Les Républicains	Les Républicains
Cordery	Philip	Socialiste, républicain et citoyen	Parti socialiste
Cornut-Gentille	François	Les Républicains	Les Républicains
Coronado	Sergio	Écologiste	Europe Ecologie Les Verts
Corre	Valérie	Socialiste, républicain et citoyen	Parti socialiste
Costes	Jean-Louis	Les Républicains	Les Républicains
Cottel	Jean-Jacques	Socialiste, républicain et citoyen	Parti socialiste
Courson (de)	Charles	Union des démocrates et indépendants	Association PSLE - Nouveau Centre
Courtial	Édouard	Les Républicains	Les Républicains
Coutelle	Catherine	Socialiste, républicain et citoyen	Parti socialiste
Couve	Jean-Michel	Les Républicains	Les Républicains
Cresta	Jacques	Socialiste, républicain et citoyen	Parti socialiste
Crozon	Pascale	Socialiste, républicain et citoyen	Parti socialiste
Cuvillier	Frédéric	Socialiste, républicain et citoyen	Parti socialiste
Da Silva	Carlos	Socialiste, républicain et citoyen	Parti socialiste
Dagoma	Seybah	Socialiste, républicain et citoyen	Parti socialiste
Dalloz	Marie-Christine	Les Républicains	Les Républicains
Daniel	Yves	Socialiste, républicain et citoyen	Parti socialiste
Darmanin	Gérald	Les Républicains	Les Républicains
Dassault	Olivier	Les Républicains	Les Républicains
Daubresse	Marc-Philippe	Les Républicains	Les Républicains
Debré	Bernard	Les Républicains	Les Républicains
Decool	Jean-Pierre	Les Républicains	Debout la France (Debout la République)
Deflesselles	Bernard	Les Républicains	Les Républicains
Degallaix	Laurent	Union des démocrates et indépendants	Union des Radicaux, centristes, indépendants et démocrates
Degauchy	Lucien	Les Républicains	Les Républicains
Deguilhem	Pascal	Socialiste, républicain et citoyen	Parti socialiste
Delatte	Rémi	Les Républicains	Les Républicains
Delaunay	Florence	Socialiste, républicain et citoyen	Parti socialiste
Delaunay	Michèle	Socialiste, républicain et citoyen	Parti socialiste
Delcourt	Guy	Socialiste, républicain et citoyen	Parti socialiste
Delga	Carole	Socialiste, républicain et citoyen	Parti socialiste
Demarthe	Pascal	Socialiste, républicain et citoyen	Parti socialiste
Demilly	Stéphane	Union des démocrates et indépendants	Association PSLE - Nouveau Centre
Denaja	Sébastien	Socialiste, républicain et citoyen	Parti socialiste
Descamps-Crosnier	Françoise	Socialiste, républicain et citoyen	Parti socialiste
Dessus	Sophie	Socialiste, républicain et citoyen	Parti socialiste
Destans	Jean-Louis	Socialiste, républicain et citoyen	Parti socialiste
Destot	Michel	Socialiste, républicain et citoyen	Parti socialiste
Devedjian	Patrick	Les Républicains	Les Républicains
Dhuicq	Nicolas	Les Républicains	Les Républicains
Dion	Sophie	Les Républicains	Les Républicains
Dolez	Marc	Gauche démocrate et républicaine	Parti communiste français
Dombre Coste	Fanny	Socialiste, républicain et citoyen	Parti socialiste
Door	Jean-Pierre	Les Républicains	Les Républicains
Dord	Dominique	Les Républicains	Les Républicains
Dosière	René	Socialiste, républicain et citoyen	Parti socialiste
Doucet	Philippe	Socialiste, républicain et citoyen	Parti socialiste
Doucet	Sandrine	Socialiste, républicain et citoyen	Parti socialiste
Douillet	David	Les Républicains	Les Républicains
Dubié	Jeanine	Radical, républicain, démocrate et progressiste	Parti radical de gauche
Dubois	Françoise	Socialiste, républicain et citoyen	Parti socialiste
Dubois	Marianne	Les Républicains	Les Républicains
Duby-Muller	Virginie	Les Républicains	Les Républicains
Dufau	Jean-Pierre	Socialiste, républicain et citoyen	Parti socialiste
Duflot	Cécile	Écologiste	Europe Ecologie Les Verts
Dufour-Tonini	Anne-Lise	Socialiste, républicain et citoyen	Parti socialiste
Dumas	Françoise	Socialiste, républicain et citoyen	Parti socialiste
Dumas	William	Socialiste, républicain et citoyen	Parti socialiste
Dumont	Jean-Louis	Socialiste, républicain et citoyen	Parti socialiste
Dumont	Laurence	Socialiste, républicain et citoyen	Parti socialiste
Dupont-Aignan	Nicolas	Non inscrit	Debout la France (Debout la République)
Dupré	Jean-Paul	Socialiste, républicain et citoyen	Parti socialiste
Durand	Yves	Socialiste, républicain et citoyen	Parti socialiste
Duron	Philippe	Socialiste, républicain et citoyen	Parti socialiste
Dussopt	Olivier	Socialiste, républicain et citoyen	Parti socialiste
Emmanuelli	Henri	Socialiste, républicain et citoyen	Parti socialiste
Erhel	Corinne	Socialiste, républicain et citoyen	Parti socialiste
Errante	Sophie	Socialiste, républicain et citoyen	Parti socialiste
Estrosi	Christian	Les Républicains	Les Républicains
Fabre	Marie-Hélène	Socialiste, républicain et citoyen	Parti socialiste
Falorni	Olivier	Radical, républicain, démocrate et progressiste	Parti radical de gauche
Fasquelle	Daniel	Les Républicains	Les Républicains
Faure	Martine	Socialiste, républicain et citoyen	Parti socialiste
Faure	Olivier	Socialiste, républicain et citoyen	Parti socialiste
Fauré	Alain	Socialiste, républicain et citoyen	Parti socialiste
Favennec	Yannick	Union des démocrates et indépendants	Union des Radicaux, centristes, indépendants et démocrates
Fenech	Georges	Les Républicains	Les Républicains
Ferrand	Richard	Socialiste, républicain et citoyen	Parti socialiste
Filippetti	Aurélie	Socialiste, républicain et citoyen	Parti socialiste
Fillon	François	Les Républicains	Les Républicains
Fioraso	Geneviève	Socialiste, républicain et citoyen	Parti socialiste
Folliot	Philippe	Union des démocrates et indépendants	Association PSLE - Nouveau Centre
Fort	Marie-Louise	Les Républicains	Les Républicains
Foulon	Yves	Les Républicains	Les Républicains
Fourage	Hugues	Socialiste, républicain et citoyen	Parti socialiste
Fournel	Jean-Marc	Socialiste, républicain et citoyen	Parti socialiste
Fourneyron	Valérie	Socialiste, républicain et citoyen	Parti socialiste
Fournier-Armand	Michèle	Socialiste, républicain et citoyen	Parti socialiste
Francaix	Michel	Socialiste, républicain et citoyen	Parti socialiste
Francina	Marc	Les Républicains	Les Républicains
Franqueville	Christian	Socialiste, républicain et citoyen	Parti socialiste
Fraysse	Jacqueline	Gauche démocrate et républicaine	Forces de Gauche
Fromantin	Jean-Christophe	Union des démocrates et indépendants	Association PSLE - Nouveau Centre
Fromion	Yves	Les Républicains	Les Républicains
Fruteau	Jean-Claude	Socialiste, républicain et citoyen	Parti socialiste
Furst	Laurent	Les Républicains	Les Républicains
Féron	Hervé	Socialiste, républicain et citoyen	Parti socialiste
Gagnaire	Jean-Louis	Socialiste, républicain et citoyen	Parti socialiste
Gaillard	Geneviève	Socialiste, républicain et citoyen	Parti socialiste
Galut	Yann	Socialiste, républicain et citoyen	Parti socialiste
Ganay (de)	Claude	Les Républicains	Les Républicains
Gandolfi-Scheit	Sauveur	Les Républicains	Les Républicains
Garot	Guillaume	Socialiste, républicain et citoyen	Parti socialiste
Gaymard	Hervé	Les Républicains	Les Républicains
Genevard	Annie	Les Républicains	Les Républicains
Geoffroy	Guy	Les Républicains	Les Républicains
Geoffroy	Hélène	Socialiste, républicain et citoyen	Parti socialiste
Germain	Jean-Marc	Socialiste, républicain et citoyen	Parti socialiste
Gest	Alain	Les Républicains	Les Républicains
Giacobbi	Paul	Radical, républicain, démocrate et progressiste	Non déclaré
Gibbes	Daniel	Les Républicains	Les Républicains
Gilard	Franck	Les Républicains	Les Républicains
Gille	Jean-Patrick	Socialiste, républicain et citoyen	Parti socialiste
Ginesta	Georges	Les Républicains	Les Républicains
Ginesy	Charles-Ange	Les Républicains	Les Républicains
Giran	Jean-Pierre	Les Républicains	Les Républicains
Giraud	Joël	Radical, républicain, démocrate et progressiste	Parti radical de gauche
Glavany	Jean	Socialiste, républicain et citoyen	Parti socialiste
Goasdoué	Yves	Socialiste, républicain et citoyen	Parti socialiste
Goasguen	Claude	Les Républicains	Les Républicains
Goldberg	Daniel	Socialiste, républicain et citoyen	Parti socialiste
Gomes	Philippe	Union des démocrates et indépendants	Calédonie ensemble
Gorges	Jean-Pierre	Les Républicains	Non déclaré
Gosselin	Philippe	Les Républicains	Les Républicains
Gosselin-Fleury	Geneviève	Socialiste, républicain et citoyen	Parti socialiste
Got	Pascale	Socialiste, républicain et citoyen	Parti socialiste
Goua	Marc	Socialiste, républicain et citoyen	Parti socialiste
Goujon	Philippe	Les Républicains	Les Républicains
Gourjade	Linda	Socialiste, républicain et citoyen	Parti socialiste
Grandguillaume	Laurent	Socialiste, républicain et citoyen	Parti socialiste
Greff	Claude	Les Républicains	Les Républicains
Grelier	Estelle	Socialiste, républicain et citoyen	Parti socialiste
Grellier	Jean	Socialiste, républicain et citoyen	Parti socialiste
Grommerch	Anne	Les Républicains	Les Républicains
Grosskost	Arlette	Les Républicains	Les Républicains
Grouard	Serge	Les Républicains	Les Républicains
Guaino	Henri	Les Républicains	Les Républicains
Gueugneau	Edith	Socialiste, républicain et citoyen	Parti socialiste
Guibal	Jean-Claude	Les Républicains	Les Républicains
Guigou	Élisabeth	Socialiste, républicain et citoyen	Parti socialiste
Guillet	Jean-Jacques	Les Républicains	Les Républicains
Guilloteau	Christophe	Les Républicains	Les Républicains
Guittet	Chantal	Socialiste, républicain et citoyen	Parti socialiste
Guégot	Françoise	Les Républicains	Les Républicains
Gérard	Bernard	Les Républicains	Les Républicains
Habib	David	Socialiste, républicain et citoyen	Parti socialiste
Habib	Meyer	Union des démocrates et indépendants	Union des Radicaux, centristes, indépendants et démocrates
Hammadi	Razzy	Socialiste, républicain et citoyen	Parti socialiste
Hamon	Benoît	Socialiste, républicain et citoyen	Parti socialiste
Hanotin	Mathieu	Socialiste, républicain et citoyen	Parti socialiste
Heinrich	Michel	Les Républicains	Les Républicains
Herbillon	Michel	Les Républicains	Les Républicains
Herth	Antoine	Les Républicains	Les Républicains
Hetzel	Patrick	Les Républicains	Les Républicains
Hillmeyer	Francis	Union des démocrates et indépendants	Association PSLE - Nouveau Centre
Hobert	Gilda	Radical, républicain, démocrate et progressiste	Parti radical de gauche
Houillon	Philippe	Les Républicains	Les Républicains
Huet	Guénhaël	Les Républicains	Les Républicains
Huillier	Joëlle	Socialiste, républicain et citoyen	Parti socialiste
Hutin	Christian	Socialiste, républicain et citoyen	Parti socialiste
Huyghe	Sébastien	Les Républicains	Les Républicains
Iborra	Monique	Socialiste, républicain et citoyen	Parti socialiste
Imbert	Françoise	Socialiste, républicain et citoyen	Parti socialiste
Issindou	Michel	Socialiste, républicain et citoyen	Parti socialiste
Jacob	Christian	Les Républicains	Les Républicains
Jacquat	Denis	Les Républicains	Les Républicains
Jalton	Éric	Socialiste, républicain et citoyen	Parti communiste guadeloupéen
Janquin	Serge	Socialiste, républicain et citoyen	Parti socialiste
Jibrayel	Henri	Socialiste, républicain et citoyen	Parti socialiste
Juanico	Régis	Socialiste, républicain et citoyen	Parti socialiste
Jung	Armand	Socialiste, républicain et citoyen	Parti socialiste
Jégo	Yves	Union des démocrates et indépendants	Union des Radicaux, centristes, indépendants et démocrates
Kalinowski	Laurent	Socialiste, républicain et citoyen	Parti socialiste
Karamanli	Marietta	Socialiste, républicain et citoyen	Parti socialiste
Kemel	Philippe	Socialiste, républicain et citoyen	Parti socialiste
Kert	Christian	Les Républicains	Les Républicains
Khirouni	Chaynesse	Socialiste, républicain et citoyen	Parti socialiste
Kosciusko-Morizet	Nathalie	Les Républicains	Les Républicains
Kossowski	Jacques	Les Républicains	Les Républicains
Krabal	Jacques	Radical, républicain, démocrate et progressiste	Parti radical de gauche
La Raudière (de)	Laure	Les Républicains	Les Républicains
La Verpillière (de)	Charles	Les Républicains	Les Républicains
Labaune	Patrick	Les Républicains	Les Républicains
Laclais	Bernadette	Socialiste, républicain et citoyen	Parti socialiste
Lacroute	Valérie	Les Républicains	Les Républicains
Lacuey	Conchita	Socialiste, républicain et citoyen	Parti socialiste
Laffineur	Marc	Les Républicains	Les Républicains
Lagarde	Sonia	Union des démocrates et indépendants	Union des Radicaux, centristes, indépendants et démocrates
Lagarde	Jean-Christophe	Union des démocrates et indépendants	Union des Radicaux, centristes, indépendants et démocrates
Lambert	François-Michel	Écologiste	Parti socialiste
Lambert	Jérôme	Radical, républicain, démocrate et progressiste	Parti socialiste
Lamblin	Jacques	Les Républicains	Les Républicains
Lamour	Jean-François	Les Républicains	Les Républicains
Lamy	François	Socialiste, républicain et citoyen	Parti socialiste
Lang	Anne-Christine	Socialiste, républicain et citoyen	Parti socialiste
Langlade	Colette	Socialiste, républicain et citoyen	Parti socialiste
Larrivé	Guillaume	Les Républicains	Les Républicains
Lassalle	Jean	Non inscrit	Le Centre pour la France
Launay	Jean	Socialiste, républicain et citoyen	Parti socialiste
Laurent	Jean-Luc	Socialiste, républicain et citoyen	Parti socialiste
Lazaro	Thierry	Les Républicains	Les Républicains
Le Borgn'	Pierre-Yves	Socialiste, républicain et citoyen	Parti socialiste
Le Bouillonnec	Jean-Yves	Socialiste, républicain et citoyen	Parti socialiste
Le Bris	Gilbert	Socialiste, républicain et citoyen	Parti socialiste
Le Callennec	Isabelle	Les Républicains	Les Républicains
Le Dain	Anne-Yvonne	Socialiste, républicain et citoyen	Parti socialiste
Le Dissez	Viviane	Socialiste, républicain et citoyen	Parti socialiste
Le Déaut	Jean-Yves	Socialiste, républicain et citoyen	Parti socialiste
Le Fur	Marc	Les Républicains	Les Républicains
Le Houerou	Annie	Socialiste, républicain et citoyen	Parti socialiste
Le Loch	Annick	Socialiste, républicain et citoyen	Parti socialiste
Le Maire	Bruno	Les Républicains	Les Républicains
Le Mèner	Dominique	Les Républicains	Les Républicains
Le Ray	Philippe	Les Républicains	Les Républicains
Le Roch	Jean-Pierre	Socialiste, républicain et citoyen	Parti socialiste
Le Roux	Bruno	Socialiste, républicain et citoyen	Parti socialiste
Le Vern	Marie	Socialiste, républicain et citoyen	Parti socialiste
Leboeuf	Alain	Les Républicains	Les Républicains
Lebreton	Patrick	Socialiste, républicain et citoyen	Parti socialiste
Lefait	Michel	Socialiste, républicain et citoyen	Parti socialiste
Lefebvre	Dominique	Socialiste, républicain et citoyen	Parti socialiste
Lefebvre	Frédéric	Les Républicains	Les Républicains
Lellouche	Pierre	Les Républicains	Les Républicains
Lemasle	Patrick	Socialiste, républicain et citoyen	Parti socialiste
Lemorton	Catherine	Socialiste, républicain et citoyen	Parti socialiste
Leonetti	Jean	Les Républicains	Les Républicains
Lepetit	Annick	Socialiste, républicain et citoyen	Parti socialiste
Lequiller	Pierre	Les Républicains	Les Républicains
Leroy	Arnaud	Socialiste, républicain et citoyen	Parti socialiste
Leroy	Maurice	Union des démocrates et indépendants	Association PSLE - Nouveau Centre
Lesage	Michel	Socialiste, républicain et citoyen	Parti socialiste
Lesterlin	Bernard	Socialiste, républicain et citoyen	Parti socialiste
Letchimy	Serge	Socialiste, républicain et citoyen	Parti progressiste martiniquais
Lett	Céleste	Les Républicains	Les Républicains
Levy	Geneviève	Les Républicains	Les Républicains
Liebgott	Michel	Socialiste, républicain et citoyen	Parti socialiste
Lignières-Cassou	Martine	Socialiste, républicain et citoyen	Parti socialiste
Linkenheld	Audrey	Socialiste, républicain et citoyen	Parti socialiste
Loncle	François	Socialiste, républicain et citoyen	Parti socialiste
Louis-Carabin	Gabrielle	Socialiste, républicain et citoyen	Démocratie et République
Lousteau	Lucette	Socialiste, républicain et citoyen	Parti socialiste
Louwagie	Véronique	Les Républicains	Les Républicains
Luca	Lionnel	Les Républicains	Les Républicains
Lurel	Victorin	Socialiste, républicain et citoyen	Parti socialiste
Lurton	Gilles	Les Républicains	Les Républicains
Léonard	Christophe	Socialiste, républicain et citoyen	Parti socialiste
Maggi	Jean-Pierre	Radical, républicain, démocrate et progressiste	Parti radical de gauche
Mamère	Noël	Écologiste	Europe Ecologie Les Verts
Mancel	Jean-François	Les Républicains	Les Républicains
Maquet	Jacqueline	Socialiste, républicain et citoyen	Parti socialiste
Marcangeli	Laurent	Les Républicains	Les Républicains
Marcel	Marie-Lou	Socialiste, républicain et citoyen	Parti socialiste
Mariani	Thierry	Les Républicains	Les Républicains
Marie-Jeanne	Alfred	Gauche démocrate et républicaine	Mouvement indépendantiste martiniquais
Mariton	Hervé	Les Républicains	Les Républicains
Marleix	Alain	Les Républicains	Les Républicains
Marleix	Olivier	Les Républicains	Les Républicains
Marlin	Franck	Les Républicains	Les Républicains
Marsac	Jean-René	Socialiste, républicain et citoyen	Parti socialiste
Marsaud	Alain	Les Républicains	Les Républicains
Martin	Philippe	Socialiste, républicain et citoyen	Parti socialiste
Martin	Philippe Armand	Les Républicains	Les Républicains
Martin-Lalande	Patrice	Les Républicains	Les Républicains
Martinel	Martine	Socialiste, républicain et citoyen	Parti socialiste
Marty	Alain	Les Républicains	Les Républicains
Maréchal-Le Pen	Marion	Non inscrit	Front national
Massat	Frédérique	Socialiste, républicain et citoyen	Parti socialiste
Massonneau	Véronique	Écologiste	Parti socialiste
Mathis	Jean-Claude	Les Républicains	Les Républicains
Mazetier	Sandrine	Socialiste, républicain et citoyen	Parti socialiste
Mazières (de)	François	Les Républicains	Les Républicains
Mennucci	Patrick	Socialiste, républicain et citoyen	Parti socialiste
Menuel	Gérard	Les Républicains	Les Républicains
Meslot	Damien	Les Républicains	Les Républicains
Mesquida	Kléber	Socialiste, républicain et citoyen	Parti socialiste
Meunier	Philippe	Les Républicains	Les Républicains
Mignon	Jean-Claude	Les Républicains	Les Républicains
Moignard	Jacques	Radical, républicain, démocrate et progressiste	Parti radical de gauche
Molac	Paul	Écologiste	Parti socialiste
Morange	Pierre	Les Républicains	Les Républicains
Moreau	Yannick	Les Républicains	Les Républicains
Morel-A-LHuissier	Pierre	Les Républicains	Les Républicains
Morin	Hervé	Union des démocrates et indépendants	Association PSLE - Nouveau Centre
Moyne-Bressand	Alain	Les Républicains	Les Républicains
Muet	Pierre-Alain	Socialiste, républicain et citoyen	Parti socialiste
Myard	Jacques	Les Républicains	Les Républicains
Ménard	Michel	Socialiste, républicain et citoyen	Parti socialiste
Nachury	Dominique	Les Républicains	Les Républicains
Nauche	Philippe	Socialiste, républicain et citoyen	Parti socialiste
Nicolin	Yves	Les Républicains	Les Républicains
Nieson	Nathalie	Socialiste, républicain et citoyen	Parti socialiste
Nilor	Jean-Philippe	Gauche démocrate et républicaine	Mouvement indépendantiste martiniquais
Noguès	Philippe	Non inscrit	Non rattaché
Olive	Robert	Socialiste, républicain et citoyen	Parti socialiste
Olivier	Maud	Socialiste, républicain et citoyen	Parti socialiste
Ollier	Patrick	Les Républicains	Les Républicains
Orliac	Dominique	Radical, républicain, démocrate et progressiste	Parti radical de gauche
Orphé	Monique	Socialiste, républicain et citoyen	Parti socialiste
Pajon	Michel	Socialiste, républicain et citoyen	Parti socialiste
Pancher	Bertrand	Union des démocrates et indépendants	Union des Radicaux, centristes, indépendants et démocrates
Pane	Luce	Socialiste, républicain et citoyen	Parti socialiste
Paul	Christian	Socialiste, républicain et citoyen	Parti socialiste
Pauvros	Rémi	Socialiste, républicain et citoyen	Parti socialiste
Peiro	Germinal	Socialiste, républicain et citoyen	Parti socialiste
Pellois	Hervé	Socialiste, républicain et citoyen	Parti socialiste
Perez	Jean-Claude	Socialiste, républicain et citoyen	Parti socialiste
Perrut	Bernard	Les Républicains	Les Républicains
Philippe	Edouard	Les Républicains	Les Républicains
Pietrasanta	Sébastien	Socialiste, républicain et citoyen	Parti socialiste
Pires Beaune	Christine	Socialiste, républicain et citoyen	Parti socialiste
Piron	Michel	Union des démocrates et indépendants	Union des Radicaux, centristes, indépendants et démocrates
Plisson	Philippe	Socialiste, républicain et citoyen	Parti socialiste
Pochon	Elisabeth	Socialiste, républicain et citoyen	Parti socialiste
Poisson	Jean-Frédéric	Les Républicains	Les Républicains
Poletti	Bérengère	Les Républicains	Les Républicains
Polutélé	Napole	Socialiste, républicain et citoyen	Parti socialiste
Pompili	Barbara	Écologiste	Parti socialiste
Poniatowski	Axel	Les Républicains	Les Républicains
Pons	Josette	Les Républicains	Les Républicains
Popelin	Pascal	Socialiste, républicain et citoyen	Parti socialiste
Potier	Dominique	Socialiste, républicain et citoyen	Parti socialiste
Pouzol	Michel	Socialiste, républicain et citoyen	Parti socialiste
Povéda	Régine	Socialiste, républicain et citoyen	Parti socialiste
Prat	Patrice	Socialiste, républicain et citoyen	Parti socialiste
Premat	Christophe	Socialiste, républicain et citoyen	Parti socialiste
Priou	Christophe	Les Républicains	Les Républicains
Pueyo	Joaquim	Socialiste, républicain et citoyen	Parti socialiste
Pupponi	François	Socialiste, républicain et citoyen	Parti socialiste
Pécresse	Valérie	Les Républicains	Les Républicains
Pélissard	Jacques	Les Républicains	Les Républicains
Quentin	Didier	Les Républicains	Les Républicains
Quéré	Catherine	Socialiste, républicain et citoyen	Parti socialiste
Rabault	Valérie	Socialiste, républicain et citoyen	Parti socialiste
Rabin	Monique	Socialiste, républicain et citoyen	Parti socialiste
Raimbourg	Dominique	Socialiste, républicain et citoyen	Parti socialiste
Reiss	Frédéric	Les Républicains	Les Républicains
Reitzer	Jean-Luc	Les Républicains	Les Républicains
Reynaud	Marie-Line	Socialiste, républicain et citoyen	Parti socialiste
Reynier	Franck	Union des démocrates et indépendants	Union des Radicaux, centristes, indépendants et démocrates
Reynès	Bernard	Les Républicains	Les Républicains
Ribeaud	Pierre	Socialiste, républicain et citoyen	Parti socialiste
Richard	Arnaud	Union des démocrates et indépendants	Union des Radicaux, centristes, indépendants et démocrates
Riester	Franck	Les Républicains	Les Républicains
Rihan Cypel	Eduardo	Socialiste, républicain et citoyen	Parti socialiste
Robert	Thierry	Radical, républicain, démocrate et progressiste	La politique autrement
Robiliard	Denys	Socialiste, républicain et citoyen	Parti socialiste
Robinet	Arnaud	Les Républicains	Les Républicains
Rocca Serra (de)	Camille	Les Républicains	Les Républicains
Rochebloine	François	Union des démocrates et indépendants	Union des Radicaux, centristes, indépendants et démocrates
Rodet	Alain	Socialiste, républicain et citoyen	Parti socialiste
Rogemont	Marcel	Socialiste, républicain et citoyen	Parti socialiste
Rohfritsch	Sophie	Les Républicains	Les Républicains
Roig	Frédéric	Socialiste, républicain et citoyen	Parti socialiste
Romagnan	Barbara	Socialiste, républicain et citoyen	Parti socialiste
Roman	Bernard	Socialiste, républicain et citoyen	Parti socialiste
Rouillard	Gwendal	Socialiste, républicain et citoyen	Parti socialiste
Roumegas	Jean-Louis	Écologiste	Europe Ecologie Les Verts
Rouquet	René	Socialiste, républicain et citoyen	Parti socialiste
Rousset	Alain	Socialiste, républicain et citoyen	Parti socialiste
Rugy (de)	François	Écologiste	Parti socialiste
Récalde	Marie	Socialiste, républicain et citoyen	Parti socialiste
Saddier	Martial	Les Républicains	Les Républicains
Sage	Maina	Union des démocrates et indépendants	Rautahi - Rassemblement pour la Polynésie française
Said	Boinali	Socialiste, républicain et citoyen	Parti socialiste
Saint-André	Stéphane	Radical, républicain, démocrate et progressiste	Parti radical de gauche
Salen	Paul	Les Républicains	Les Républicains
Salles	Rudy	Union des démocrates et indépendants	Association PSLE - Nouveau Centre
Sansu	Nicolas	Gauche démocrate et républicaine	Parti communiste français
Santais	Béatrice	Socialiste, républicain et citoyen	Parti socialiste
Santini	André	Union des démocrates et indépendants	Union des Radicaux, centristes, indépendants et démocrates
Sas	Eva	Écologiste	Europe Ecologie Les Verts
Saugues	Odile	Socialiste, républicain et citoyen	Parti socialiste
Sauvadet	François	Union des démocrates et indépendants	Union des Radicaux, centristes, indépendants et démocrates
Sauvan	Gilbert	Socialiste, républicain et citoyen	Parti socialiste
Savary	Gilles	Socialiste, républicain et citoyen	Parti socialiste
Scellier	François	Les Républicains	Les Républicains
Schmid	Claudine	Les Républicains	Les Républicains
Schneider	André	Les Républicains	Les Républicains
Schwartzenberg	Roger-Gérard	Radical, républicain, démocrate et progressiste	Parti radical de gauche
Sebaoun	Gérard	Socialiste, républicain et citoyen	Parti socialiste
Sermier	Jean-Marie	Les Républicains	Les Républicains
Serville	Gabriel	Gauche démocrate et républicaine	Parti socialiste Guyanais
Sirugue	Christophe	Socialiste, républicain et citoyen	Parti socialiste
Siré	Fernand	Les Républicains	Les Républicains
Solère	Thierry	Les Républicains	Les Républicains
Sommaruga	Julie	Socialiste, républicain et citoyen	Parti socialiste
Sordi	Michel	Les Républicains	Les Républicains
Straumann	Éric	Les Républicains	Les Républicains
Sturni	Claude	Les Républicains	Les Républicains
Suguenot	Alain	Les Républicains	Les Républicains
Tabarot	Michèle	Les Républicains	Les Républicains
Tahuaitu	Jonas	Union des démocrates et indépendants	Tahoeraa Huiraatira
Tallard	Suzanne	Socialiste, républicain et citoyen	Parti socialiste
Tardy	Lionel	Les Républicains	Les Républicains
Taugourdeau	Jean-Charles	Les Républicains	Les Républicains
Teissier	Guy	Les Républicains	Les Républicains
Terrasse	Pascal	Socialiste, républicain et citoyen	Parti socialiste
Terrot	Michel	Les Républicains	Les Républicains
Tetart	Jean-Marie	Les Républicains	Les Républicains
Thévenoud	Thomas	Non inscrit	Parti radical de gauche
Tian	Dominique	Les Républicains	Les Républicains
Tolmont	Sylvie	Socialiste, républicain et citoyen	Parti socialiste
Touraine	Jean-Louis	Socialiste, républicain et citoyen	Parti socialiste
Tourret	Alain	Radical, républicain, démocrate et progressiste	Parti radical de gauche
Travert	Stéphane	Socialiste, républicain et citoyen	Parti socialiste
Troallic	Catherine	Socialiste, républicain et citoyen	Parti socialiste
Tuaiva	Jean-Paul	Union des démocrates et indépendants	Rautahi - Rassemblement pour la Polynésie française
Untermaier	Cécile	Socialiste, républicain et citoyen	Parti socialiste
Urvoas	Jean-Jacques	Socialiste, républicain et citoyen	Parti socialiste
Vaillant	Daniel	Socialiste, républicain et citoyen	Parti socialiste
Valax	Jacques	Socialiste, républicain et citoyen	Parti socialiste
Vannson	François	Les Républicains	Les Républicains
Vautrin	Catherine	Les Républicains	Les Républicains
Vauzelle	Michel	Socialiste, républicain et citoyen	Parti socialiste
Vercamer	Francis	Union des démocrates et indépendants	Association PSLE - Nouveau Centre
Verchère	Patrice	Les Républicains	Les Républicains
Verdier	Fabrice	Socialiste, républicain et citoyen	Parti socialiste
Vergnier	Michel	Socialiste, républicain et citoyen	Parti socialiste
Viala	Arnaud	Les Républicains	Les Républicains
Vialatte	Jean-Sébastien	Les Républicains	Les Républicains
Vigier	Jean-Pierre	Les Républicains	Les Républicains
Vigier	Philippe	Union des démocrates et indépendants	Union des Radicaux, centristes, indépendants et démocrates
Vignal	Patrick	Socialiste, républicain et citoyen	Parti socialiste
Villain	François-Xavier	Union des démocrates et indépendants	Union des Radicaux, centristes, indépendants et démocrates
Villaumé	Jean-Michel	Socialiste, républicain et citoyen	Parti socialiste
Vitel	Philippe	Les Républicains	Les Républicains
Vlody	Jean Jacques	Socialiste, républicain et citoyen	Parti socialiste
Voisin	Michel	Les Républicains	Les Républicains
Warsmann	Jean-Luc	Les Républicains	Les Républicains
Wauquiez	Laurent	Les Républicains	Les Républicains
Woerth	Éric	Les Républicains	Les Républicains
Zanetti	Paola	Socialiste, républicain et citoyen	Parti socialiste
Zimmermann	Marie-Jo	Les Républicains	Les Républicains
Zumkeller	Michel	Union des démocrates et indépendants	Union des Radicaux, centristes, indépendants et démocrates
